+-------------+
|.............|
|.............|
|.............|
|.............|
|.............|
|.............|
|.............|
|.............#
|.............|
|.............|
|.............|
|.............|
|.............|
|.............#
|.............|
|.............|
|.............|
|.............|
|.............|
+-------------+
